124
15
22 22 22 22 22 22 22 22 22 22 22 22 22 22 22 22 22 22 22 22 22 22 22 22 22 22 22 22 22 22 22 22 22 22 22 22 22 22 22 22 22 22 22 22 22 22 22 22 22 22 22 22 22 22 22 22 22 22 22 22 22 22 22 22 22 22 22 22 22 22 17 0 0 0 0 0 0 0 0 0 0 0 0 0 0 0 0 0 0 0 0 0 0 0 0 0 0 0 0 0 0 0 0 0 0 0 0 0 0 0 0 0 0 0 0 0 0 0 0 0 0 0 0 0 
22 19 17 17 17 17 17 17 17 17 17 17 17 17 17 17 17 17 17 17 17 17 17 17 17 17 17 17 17 17 17 17 17 17 17 17 17 17 17 17 17 17 17 17 17 17 17 17 17 18 22 22 22 22 22 22 22 22 22 22 22 22 22 22 22 22 22 22 22 17 0 0 0 0 0 0 0 0 0 0 0 0 0 0 0 0 0 0 0 0 0 0 0 0 0 0 0 0 0 0 0 0 0 0 0 0 0 0 0 0 0 0 0 0 0 0 0 0 0 0 0 0 0 0 
22 4 0 0 0 0 0 0 0 0 0 0 0 0 0 0 0 0 0 0 0 0 0 0 0 0 0 0 0 0 0 0 0 0 0 0 0 0 0 0 0 0 0 0 0 0 0 0 0 0 18 22 22 22 22 22 22 22 22 22 22 22 22 22 22 22 19 18 19 0 0 0 0 0 0 0 0 0 0 0 0 0 0 0 0 0 0 0 0 9 0 0 0 0 0 0 0 0 0 0 0 0 0 0 0 0 0 0 0 0 0 0 0 0 0 0 0 0 0 0 0 0 0 0 
22 4 0 0 0 0 0 0 0 0 0 0 0 0 0 0 0 0 0 0 0 0 0 0 0 0 0 0 0 0 0 0 0 0 0 0 0 0 0 0 0 3 21 21 4 0 0 0 0 0 0 18 22 22 22 22 22 22 22 22 22 22 22 22 22 19 0 3 4 0 0 0 0 0 0 0 0 0 0 0 0 0 0 0 0 0 0 0 0 21 21 0 0 9 0 0 0 0 0 0 0 0 0 0 0 0 0 0 0 0 0 0 0 0 0 0 0 0 0 0 0 0 0 16 
22 4 0 0 0 0 0 0 0 0 0 0 0 0 0 0 0 0 0 0 0 0 0 0 0 0 0 0 0 0 0 0 0 0 0 0 0 0 0 0 0 3 22 22 4 0 0 0 0 0 0 0 17 18 22 22 22 22 22 22 22 22 22 22 22 4 0 3 4 0 0 0 0 23 24 24 24 24 24 25 0 0 0 23 24 24 24 25 0 22 22 0 23 25 0 0 0 0 23 25 0 0 0 23 25 0 0 0 23 25 0 0 0 23 25 0 0 0 23 25 0 0 0 21 
22 4 0 0 0 0 0 0 0 0 0 0 0 0 0 0 0 0 0 0 0 0 0 0 0 0 0 0 0 0 0 0 0 0 0 0 0 0 0 0 0 21 22 22 4 0 0 0 0 0 0 0 0 0 18 22 22 22 22 22 22 22 22 22 22 4 0 3 4 0 0 0 0 0 0 0 0 0 0 0 0 0 0 0 0 0 0 0 0 22 22 0 0 0 0 9 0 0 3 4 0 0 0 3 4 0 0 0 3 4 0 0 0 3 4 0 0 0 3 4 0 0 0 22 
22 4 0 0 0 0 0 0 0 0 0 0 0 0 0 0 0 0 0 0 0 0 0 0 0 0 0 0 0 0 0 0 0 0 0 0 0 0 0 0 0 3 22 22 4 0 0 0 0 0 0 0 0 0 0 18 22 22 22 22 22 22 22 22 22 22 22 22 22 22 22 0 0 0 0 0 0 0 0 0 0 0 0 0 0 0 0 0 0 22 22 0 0 0 0 23 25 0 3 4 0 0 0 3 4 0 0 0 3 4 0 0 0 3 4 0 0 0 3 4 0 0 0 22 
22 4 0 0 0 0 0 0 0 0 0 0 0 0 0 0 0 0 0 0 0 0 0 0 0 13 0 0 0 10 13 0 0 0 0 13 0 0 0 0 0 3 22 22 4 0 0 0 0 0 0 0 0 0 0 0 17 18 22 22 22 22 19 0 0 0 0 0 0 0 0 0 0 0 0 0 0 0 0 0 0 0 0 0 0 0 0 0 0 22 22 0 0 9 0 0 0 0 3 4 0 0 0 3 4 0 0 0 3 4 0 0 0 3 4 0 0 0 3 4 0 0 0 22 
22 4 0 0 0 0 0 0 0 0 0 0 0 0 0 0 0 0 0 0 15 13 0 0 23 24 25 0 0 23 24 25 0 0 23 24 25 0 3 21 21 21 22 22 4 0 0 0 0 0 0 0 0 0 0 0 0 3 22 22 22 22 4 0 0 0 0 0 0 0 0 0 0 0 0 0 0 0 0 0 0 0 0 0 0 0 0 0 0 22 22 0 23 25 0 0 0 0 3 4 0 0 0 3 4 0 0 0 3 4 0 0 0 3 4 0 0 0 3 4 0 0 0 22 
22 4 0 0 0 0 0 0 0 0 0 0 0 0 0 0 0 0 0 21 21 21 4 0 0 0 0 0 0 0 0 0 0 0 0 0 0 0 3 22 22 22 22 22 4 0 0 0 0 0 0 0 0 0 0 0 0 3 22 22 22 19 0 0 0 0 0 0 0 0 0 0 0 23 25 0 0 0 0 0 0 0 0 0 0 0 0 0 0 22 22 0 0 0 0 0 10 0 3 4 0 0 0 3 4 0 0 0 3 4 0 0 0 3 4 0 0 0 3 4 0 0 0 22 
22 4 0 0 0 0 0 0 0 0 0 0 0 0 0 0 9 0 0 22 22 22 4 0 0 0 0 0 0 0 0 0 0 0 0 0 0 0 3 22 22 22 22 22 4 0 0 0 0 0 0 0 0 0 0 0 0 3 22 22 22 4 0 0 0 0 0 0 0 0 0 0 0 3 4 0 0 23 25 0 0 23 25 0 0 23 25 0 0 22 22 0 0 0 0 23 25 0 3 4 0 0 0 3 4 0 0 0 3 4 0 0 0 3 4 0 0 0 3 4 0 0 0 22 
22 4 0 0 12 0 0 0 0 0 0 0 0 0 13 3 21 21 21 22 22 22 4 0 0 0 0 0 0 0 0 0 0 0 0 0 0 0 3 22 22 22 22 22 4 0 0 0 0 0 0 0 0 0 0 0 0 3 22 22 19 0 0 0 0 0 0 0 0 0 0 0 0 3 4 0 0 3 4 0 0 0 0 0 0 3 4 0 21 22 22 0 9 10 0 0 0 0 3 4 0 0 0 3 4 0 0 0 3 4 0 0 0 3 4 0 0 0 3 4 0 0 0 22 
22 4 0 0 14 0 0 0 0 0 0 0 0 0 0 3 22 22 22 22 22 22 4 0 0 0 0 0 0 0 0 0 0 0 0 0 0 0 3 22 22 22 22 22 4 0 0 0 0 0 0 0 0 0 0 0 0 0 17 17 0 0 0 0 0 0 0 0 0 0 0 0 0 3 4 0 0 3 4 0 0 0 0 0 0 3 4 0 22 22 22 0 23 25 0 0 0 0 3 4 0 0 0 3 4 0 0 0 3 4 0 0 0 3 4 0 0 0 3 4 0 0 0 22 
22 4 0 0 0 0 0 0 0 0 0 0 0 0 0 0 17 17 17 17 17 17 0 21 21 21 0 0 0 0 0 0 0 0 0 0 0 0 3 22 22 22 22 22 4 0 0 0 0 0 0 0 0 0 21 21 21 0 0 0 0 0 0 0 0 0 0 0 0 0 0 0 0 3 4 0 0 3 4 0 0 0 0 0 0 3 4 0 22 22 22 0 0 9 0 0 0 0 3 4 0 0 9 3 4 0 0 0 3 4 0 0 0 3 4 0 0 0 3 4 0 0 0 22 
22 22 21 21 21 21 21 21 21 21 21 21 21 21 21 21 21 21 21 21 21 21 21 22 22 22 21 21 21 21 21 21 21 21 21 21 21 21 21 22 22 22 22 22 21 21 21 21 21 21 21 21 21 21 22 22 22 21 21 21 21 21 21 21 21 21 21 4 0 3 21 21 21 21 21 4 3 21 21 21 21 21 21 4 3 21 21 21 22 22 22 21 21 21 21 21 21 21 22 22 21 21 21 22 22 21 21 21 22 22 21 21 21 22 22 21 21 21 22 22 21 21 21 22 
